20 15
1 14
3 4 4 4 4 4 4 4 4 4 4 4 4 4 4 4 4 4 4 3
3 5 4 4 4 4 4 5 4 4 4 4 4 4 4 4 4 4 4 3
3 4 4 4 5 4 0 0 0 4 4 7 5 4 4 5 4 4 4 3
3 4 5 4 4 4 4 5 4 4 0 0 4 4 4 4 4 4 4 3
3 1 4 4 4 4 4 4 4 4 4 4 4 4 4 4 4 4 4 3
3 4 4 4 4 0 4 4 4 4 4 4 4 4 4 4 4 4 4 3
2 4 4 4 4 2 4 0 4 4 4 4 4 4 4 4 4 4 1 3
2 4 4 4 4 4 4 4 4 4 4 0 4 4 4 4 4 4 4 3
2 4 4 4 4 4 4 4 4 7 4 4 4 7 4 4 4 4 4 3
2 4 4 4 4 4 4 4 4 0 4 4 4 0 4 4 4 4 4 3
2 4 4 4 4 4 7 4 4 4 4 4 4 4 4 4 4 4 4 3
1 4 4 4 4 4 0 0 0 0 4 7 4 4 4 4 1 4 4 3
1 4 4 4 4 1 1 1 1 1 0 0 4 4 4 4 4 4 3 3
1 4 4 4 1 1 1 1 1 1 1 1 0 4 4 4 4 4 4 3
1 3 3 3 3 3 3 3 3 3 3 3 3 3 3 3 3 3 3 3